14
100 200 70 70 500 500 1 3 100 100
500 100 70 70 300 100 5 3 100 100
1200 400 70 70 500 300 6.5 3 100 100
100 100 70 70 200 500 7.2 3 800 100
500 500 70 70 300 100 9 3 100 100
1200 500 70 70 400 300 9.5 3 200 100
100 500 70 70 200 600  10 1 700 100
100 100 70 70 500 400 1 3 100 100
500 500 70 70 300 300 5 3 100 100
1200 500 70 70 800 400 6.5 3 100 100
1200 500 70 70 600 500 7.2 3 800 100
500 100 70 70 300 600 9 3 100 100
900 200 70 70 400 300 9.5 3 200 100
1200 300 70 70 500 600  10 1 700 100