10
200 200 70 70 300 300 1 3 100 100
300 250 80 80 300 500 3 4 100 100
400 550 70 70 350 450 4 3 200 100
450 600 70 70 100 500 5 3 100 100
320 260 70 70 600 550 6 3 100 100
700 550 70 70 100 200 7 4 100 100
700 440 70 70 150 550 8 3 100 100
900 100 70 70 720 360 8.5 4 200 100
150 340 70 70 190 450 9 4 100 100
340 600 70 70 1000 390 10 3 100 100
